{
  "comment": "NPC51File[floorId 0..45][slot 0..15] from MyConst.pas. Maps a stage NPC (skin=51) to a MONSTER_FILE index. 0=no model, 112=unsupported slot (no model).",
  "byFloorAndSlot": [
    [112,112,112,112,112,112,112,112,112,112,112,112,112,112,112,112],
    [113,  9, 11, 10,  5,  6,  3,  4,  8,  7,114,116,117,112,112,112],
    [113,  9, 11, 10,  5,  6,  3,  4,  8,  7,114,115,  1,  2,116,117],
    [113, 15, 21, 23, 22, 17, 18, 16, 12,118, 13,112,112,112,112,112],
    [113, 15, 19, 20, 17, 18, 16, 12,118, 13,112,112,112,112,112,112],
    [113, 15, 21, 23, 22, 19, 20, 17, 18, 16, 12,118, 13,112,112,112],
    [113, 28, 29, 50, 24, 25, 25, 26, 27,112,112,112,112,112,112,112],
    [113, 28, 29, 50, 24, 25, 25, 26, 27,119,112,112,112,112,112,112],
    [ 40, 39, 37, 30, 43, 42, 41, 31,120,121,112,112,112,112,112,112],
    [ 36, 30, 43, 42, 41,120,121,112,112,112,112,112,112,112,112,112],
    [ 37, 36, 43, 42, 41, 31,120,121,112,112,112,112,112,112,112,112],
    [112,112,112,112,112,112,112,112,112,112,112,112,112,112,112,112],
    [112,112,112,112,112,112,112,112,112,112,112,112,112,112,112,112],
    [112,112,112,112,112,112,112,112,112,112,112,112,112,112,112,112],
    [112,112,112,112,112,112,112,112,112,112,112,112,112,112,112,112],
    [112,112,112,112,112,112,112,112,112,112,112,112,112,112,112,112],
    [112,112,112,112,112,112,112,112,112,112,112,112,112,112,112,112],
    [112,112,112,112,112,112,112,112,112,112,112,112,112,112,112,112],
    [112,112,112,112,112,112,112,112,112,112,112,112,112,112,112,112],
    [  5,  6,  3,  4, 37, 43, 42, 41,115,  1,  2, 12,118,121,120,112],
    [  5,  6,  3,  4, 37, 43, 42, 41,115,  1,  2, 12,118,121,120,112],
    [  8,  7, 30, 50, 24, 25, 25, 21, 23, 22,120,112,112,112,112,112],
    [  8,  7, 30, 50, 24, 21, 23, 22, 31,120,112,112,112,112,112,112],
    [  5, 51, 59, 60, 54,112, 52,112, 53,122,123,124, 55, 56, 61,112],
    [  5, 51, 59, 60, 54,112, 52,112, 53,122,123,124, 55, 56, 61,112],
    [  5, 51, 59, 60, 54,112, 52,112, 53,122,123,124, 55, 56, 61,112],
    [  5, 51, 59, 60, 54,112, 52,112, 53,122,123,124, 55, 56, 61,112],
    [  5, 51, 59, 60, 54,112, 52,112, 53,122,123,124, 55, 56, 61,112],
    [125, 68, 67,127, 64, 72, 71,126, 69, 70, 69, 70, 66, 65,112,112],
    [125, 68, 67,127, 64, 72, 71,126, 69, 70, 69, 70, 66, 65,112,112],
    [112,112,112,112,112,112,112,112,112,112,112,112,112,112,112,112],
    [112,112,112,112,112,112,112,112,112,112,112,112,112,112,112,112],
    [112,112,112,112,112,112,112,112,112,112,112,112,112,112,112,112],
    [112,112,112,112,112,112,112,112,112,112,112,112,112,112,112,112],
    [  5, 51, 68, 67,112, 60, 54,128,128, 52, 53,122,123,124, 64, 65],
    [ 68, 67, 83,122, 55, 56, 82, 61, 72, 84,112,112,112,112,112,112],
    [  0,  0,  0,  0,  0,  0,  0,  0,  0,  0,  0,  0,  0,  0,  0,  0],
    [  0,  0,  0,  0,  0,  0,  0,  0,  0,  0,  0,  0,  0,  0,  0,  0],
    [  0,  0,  0,  0,  0,  0,  0,  0,  0,  0,  0,  0,  0,  0,  0,  0],
    [  0,  0,  0,  0,  0,  0,  0,  0,  0,  0,  0,  0,  0,  0,  0,  0],
    [  0,  0,  0,  0,  0,  0,  0,  0,  0,  0,  0,  0,  0,  0,  0,  0],
    [  0,  0,  0,  0,  0,  0,  0,  0,  0,  0,  0,  0,  0,  0,  0,  0],
    [  0,  0,  0,  0,  0,  0,  0,  0,  0,  0,  0,  0,  0,  0,  0,  0],
    [  0,  0,  0,  0,  0,  0,  0,  0,  0,  0,  0,  0,  0,  0,  0,  0],
    [  0,  0,  0,  0,  0,  0,  0,  0,  0,  0,  0,  0,  0,  0,  0,  0],
    [  0,  0,  0,  0,  0,  0,  0,  0,  0,  0,  0,  0,  0,  0,  0,  0]
  ]
}
